#########################
#}.....................o#
#o.....................o#
#.......................#
  ######.##   ##.######. 
 .#    #.#     #.#    #. 
#.######.#######.######.#
#.......................#
#oM....................o#
#########################
